1111111
1000P01
1E00101
100C001
1111111