111111111111111111111
10C0000000000000000C1
100E001100P0011000001
100000110000011000001
111111111111111111111