1111111111111111111111111111111111111111
1000P011000P011000P011000P011000P0100011
1E001011E001011E001011E001011E00101E0011
100C001100C001100C001100C001100C01100C11
1111111111111111111111111111111111111111
100C001100C001100C001100C001100C00100C11
1111111111111111111111111111111111111111
100C001100C001100C001100C001100C00110C11
1111111111111111111111111111111111111111
100C001100C001100C001100C001100C00110011
1111111111111111111111111111111111111111
100C001100C001100C001100C001100C00110011
1111111111111111111111111111111111111111
1111111111111111111111111111111111111111
100C001100C001100C001100C001100C00110011
1111111111111111111111111111111111111111
1111111111111111111111111111111111111111
100C001100C001100C001100C001100C00110011
1111111111111111111111111111111111111111
1111111111111111111111111111111111111111
100C001100C001100C001100C001100C00110011
1111111111111111111111111111111111111111
1111111111111111111111111111111111111111
100C001100C001100C001100C001100C00110011
1111111111111111111111111111111111111111