111111
1CC001
10EP01
101001
111111
