1111111111111111111111111111111111111111111111111111111111111111111111111111111111111111111111111111111
100000000000000000000000000000000000000000000000000000000000000000000000000000000000000000000000000CPE1
1111111111111111111111111111111111111111111111111111111111111111111111111111111111111111111111111111111